2
 | | | | | | |
 | | | | | | |
 | | | | | | |
 | | | | | | |
 | | | | | | |
 | | | | | | |
 | | |R| | | |
 | | |R| | | |
 | |B|B| | | |
 | |B|R|B|B| |