2
 | | | | | | |
 | | | | | | |
 | | | | | | |
 | | | | | | |
 | | | | | | |
 |G|G| | | | |
 |G|G|R| | | |
G|R|R|G|R|R| |
G|R|G|R|G|G| |
R|G|R|R|G|R|R|