1
 | | | | | | |
 | | | | | | |
 | | | | | | |
 | | | | | | |
 | | |G|G| | |
 | |P|G|G| | |
 | |Y|P|B| | |
 | |O|O|P|G| |
 |Y|P|P|Y|G| |
Y|P|Y|Y|O|B|B|