3
 | | | | | | |
 | | | | | | |
 | | | | | | |
 | | | | | | |
 | | | | | | |
 | | | | | | |
 | | | | | | |
 | | |P| | | |
 | | |G|P| | |
 | |G|P|G|P|P|