1
 | | | | | | |
 | | | | | | |
 | | | | | | |
 | | | | | | |
 | | | | | | |
 | | | | | | |
 | | | | | | |
 | |O|G|G| | |
 | |B|B|O|G| |
 | |O|O|B|O|O|