2
 | | | | | | |
 | | | | | | |
 | | | | | | |
 | | | | |B| |
 | | | |B|G| |
 | | | |B|B|G|
 | | |B|P|G|G|
 | |B|P|B|P|B|
 | |Y|R|R|B|G|
Y|Y|R|B|B|G|B|