2
 | | | | | | |
 | | | | | | |
 | | | | | | |
 | | | | | | |
 | | | | | | |
 | | | | | | |
 | | | | | | |
 | |P|P| | | |
 | |Y|B|P| | |
 |B|Y|B|Y|Y| |