1
 | | | | | | |
 | | | | | | |
 | | | | | | |
 | | | | | | |
 | | | | | | |
 | | |Y| | | |
 | | |B| | | |
 | | |R| | | |
 | |Y|B|Y| | |
 | |R|B|R| | |